{
    "0": [
        "                              ",
        "                              ",
        "                              ",
        "                              ",
        "                              ",
        "                              ",
        "                              ",
        "                              ",
        "                ***           ",
        "                ***           ",
        "     ****                     ",
        "     ****                     ",
        "                              ",
        "                              ",
        "                              ",
        "                              ",
        "                         ***  ",
        "                         ***  ",
        "                              ",
        "                              ",
        "                              ",
        "                              ",
        "****                          ",
        "****                          ",
        "****                          ",
        "****                          ",
        "****               **         ",
        "****               **         ",
        "******************************",
        "******************************"
    ],
    "1": [
        "                              ",
        "                              ",
        "                              ",
        "  G                           ",
        "******                        ",
        "******                        ",
        "                              ",
        "                              ",
        "                              ",
        "                              ",
        "                              ",
        "                 ***          ",
        "                 ***          ",
        "                              ",
        "                              ",
        "                              ",
        "                              ",
        "                              ",
        "    **                        ",
        "    **                        ",
        "                              ",
        "                              ",
        "                              ",
        "                              ",
        "                              ",
        "                              ",
        "                        ***   ",
        "                        ***   ",
        "                              ",
        "                              "
    ]
}
